{
  "1": "១",
  "2": "២",
  "3": "៣",
  "4": "៤",
  "5": "៥",
  "6": "៦",
  "7": "៧",
  "8": "៨",
  "9": "៩",
  "0": "០",
  "-": "ឥ",
  "=": "ឲ",
  "q": "ឆ",
  "w": "ឹ",
  "e": "េ",
  "r": "េ",
  "t": "ត",
  "y": "យ",
  "u": "ុ",
  "i": "ិ",
  "o": "ោ",
  "p": "ផ",
  "[": "ៀ",
  "]": "ឪ",
  "\\": "ឭ",
  "a": "ា",
  "s": "ស",
  "d": "ដ",
  "f": "ថ",
  "g": "ង",
  "h": "ហ",
  "j": "្",
  "k": "ក",
  "l": "ល",
  ";": "ើ",
  "'": "់",
  "z": "ឋ",
  "x": "ខ",
  "c": "ច",
  "v": "វ",
  "b": "ប",
  "n": "ន",
  "m": "ម",
  ",": "ឦ",
  ".": "។",
  "/": "៊",
  "!": "!",
  "@": "ៗ",
  "#": "\"",
  "$": "៛",
  "%": "%",
  "^": "៍",
  "&": "័",
  "*": "៏",
  "(": "ឰ",
  ")": "ឳ",
  "_": "៌",
  "+": "៎",
  "Q": "ឈ",
  "W": "ឺ",
  "E": "ែ",
  "R": "ឬ",
  "T": "ទ",
  "Y": "ួ",
  "U": "ូ",
  "I": "ី",
  "O": "ៅ",
  "P": "ភ",
  "{": "ឿ",
  "}": "ឧ",
  "|": "ឮ",
  "A": "ឫ",
  "S": "ៃ",
  "D": "ឌ",
  "F": "ធ",
  "G": "អ",
  "H": "ះ",
  "J": "ញ",
  "K": "គ",
  "L": "ឡ",
  ":": "៖",
  "\"": "៉",
  "Z": "ឍ",
  "X": "ឃ",
  "C": "ជ",
  "V": "ៈ",
  "B": "ព",
  "N": "ណ",
  "M": "ំ",
  "<": "៕",
  ">": "ឱ",
  "?": "ឯ"
}
